00210041
10011011
11001001
12003001
11110021