300120011011
100110110001
110010010011
120000010020
111100011110
000020000100
011000100201
012010101001
111010111104